+-+-+-+-+-+-+-+-+-+-+
S   |       | |   | |
+-+ + +-+-+ + + + + +
| | |   |   |   |   |
+ + +-+ + +-+ + +-+-+
|       |   | | |   |
+ +-+-+-+-+ + +-+ + +
| |         |   | | |
+-+ +-+-+ +-+-+ + + +
|   |     | |   | | |
+ +-+ +-+-+ + + + +-+
|   |         | |   |
+-+ +-+-+ + +-+ +-+ +
| | |     | |   |   |
+ + + +-+-+-+ +-+ +-+
|   | |   |   |   | |
+-+-+ + + + +-+ +-+ +
| |   | | |     |   |
+ + + +-+ +-+-+-+ + +
|   |             | F
+-+-+-+-+-+-+-+-+-+-+
