+----+----+----+----+----+----+----+----+----+----+
|    |         |         |              |         |
|    |         |         |              |         |
S    |         |         |              |         |
|    |         |         |              |         |
+    +----+    +    +    +----+----+    +----+    +
|         |    |    |         |    |              |
|         |    |    |         |    |              |
|         |    |    |         |    |              |
|         |    |    |         |    |              |
+----+    +    +----+----+    +    +----+    +----+
|         |         |         |         |    |    |
|         |         |         |         |    |    |
|         |         |         |         |    |    |
|         |         |         |         |    |    |
+    +----+----+    +    +----+----+    +    +    +
|    |         |    |                   |         |
|    |         |    |                   |         |
|    |         |    |                   |         |
|    |         |    |                   |         |
+    +    +    +    +----+----+----+    +----+    +
|    |    |                                  |    |
|    |    |                                  |    |
|    |    |                                  |    |
|    |    |                                  |    |
+    +    +    +----+----+----+----+----+----+    +
|         |    |                   |         |    |
|         |    |                   |         |    |
|         |    |                   |         |    |
|         |    |                   |         |    |
+----+----+    +    +    +----+    +    +    +    +
|              |    |    |         |    |         |
|              |    |    |         |    |         |
|              |    |    |         |    |         |
|              |    |    |         |    |         |
+    +----+----+    +    +----+----+----+    +----+
|         |         |         |         |         |
|         |         |         |         |         |
|         |         |         |         |         |
|         |         |         |         |         |
+----+    +    +----+----+    +----+    +----+    +
|         |    |         |         |              |
|         |    |         |         |              |
|         |    |         |         |              |
|         |    |         |         |              |
+    +----+    +    +    +    +    +----+    +    +
|              |    |         |              |    |
|              |    |         |              |    |
|              |    |         |              |    F
|              |    |         |              |    |
+----+----+----+----+----+----+----+----+----+----+
