+--+--+--+--+--+--+--+--+--+--+--+--+--+--+--+--+--+--+--+--+--+--+--+--+--+--+--+--+--+--+--+--+--+--+--+--+--+--+--+--+--+--+--+--+--+--+--+--+--+
S  |           |     |              |                 |     |        |     |     |                       |     |     |              |           |  |
+  +  +--+--+  +  +--+  +--+  +--+  +--+--+--+--+--+  +  +--+  +  +  +  +--+  +  +  +--+--+--+--+--+--+  +  +  +--+  +  +--+--+--+  +  +--+--+  +  +
|     |        |        |  |  |     |           |     |     |  |  |  |     |  |  |           |  |     |  |  |        |  |     |     |  |     |  |  |
+--+--+  +--+--+--+--+--+  +  +  +--+  +--+--+  +  +--+--+  +  +--+  +--+  +  +  +--+--+--+  +  +  +  +  +  +--+--+--+  +  +  +  +--+  +  +--+  +  +
|     |  |     |        |     |  |     |     |        |  |  |     |  |  |     |        |     |     |     |     |        |  |  |     |  |           |
+--+  +  +--+  +  +--+  +  +--+--+  +--+  +  +--+  +  +  +  +  +  +  +  +--+--+--+--+  +  +--+  +--+--+--+--+  +  +  +  +  +  +--+  +  +--+--+--+  +
|     |        |  |     |        |     |  |     |  |        |  |  |  |     |           |     |  |              |  |  |     |     |     |           |
+  +--+  +--+  +--+  +--+--+--+  +--+  +  +--+  +  +--+  +--+  +--+  +--+  +  +--+--+--+--+--+  +  +--+  +--+--+  +  +--+--+--+  +--+--+  +--+--+--+
|           |  |     |           |  |  |     |  |     |     |     |        |     |              |  |     |     |  |  |        |        |  |  |     |
+--+  +  +  +--+  +--+  +--+--+--+  +  +--+--+  +--+--+  +--+--+  +--+--+  +--+  +  +--+  +--+--+  +  +--+  +  +  +--+  +--+  +--+--+  +  +  +  +  +
|     |  |  |     |     |        |  |  |        |                    |     |     |     |           |  |     |     |     |     |  |     |     |  |  |
+  +--+  +--+  +--+  +--+--+--+  +  +  +  +--+--+  +--+--+--+--+--+  +  +--+  +  +  +  +--+--+--+--+  +  +--+--+--+  +--+  +--+  +  +--+  +--+  +  +
|  |     |           |           |  |  |  |  |     |     |     |     |     |  |  |  |  |                 |     |     |  |     |     |           |  |
+  +--+--+  +  +--+--+  +--+--+--+  +  +  +  +  +--+  +  +  +  +  +--+--+  +  +  +  +  +  +--+  +--+--+--+  +  +  +--+  +  +  +--+--+--+  +--+--+  +
|        |  |        |        |        |  |  |        |     |  |        |     |  |  |  |     |  |  |     |  |  |        |  |  |        |     |     |
+--+--+  +  +  +--+  +  +--+  +  +--+--+  +  +--+--+--+--+--+  +--+--+  +--+--+--+  +--+--+--+  +  +  +  +  +  +--+  +--+--+  +  +--+  +--+--+  +--+
|        |  |  |     |  |     |     |           |              |     |     |        |     |     |     |  |  |        |  |     |  |     |     |     |
+  +--+--+--+  +  +--+  +  +--+--+  +  +--+--+  +  +--+--+--+--+  +  +--+  +  +--+--+  +  +  +--+--+  +  +--+--+--+--+  +  +  +  +--+  +  +  +--+  +
|  |           |        |        |  |  |     |  |        |        |        |           |  |           |                    |     |     |  |  |     |
+  +  +--+--+--+--+--+--+--+--+  +--+  +  +--+  +--+--+--+  +--+--+--+--+--+--+  +--+--+--+--+--+--+--+--+--+--+--+--+--+--+--+--+  +--+--+  +  +--+
|  |  |           |              |     |  |     |     |     |        |           |  |              |           |              |  |  |     |  |     |
+  +  +--+--+  +  +  +--+  +--+--+  +--+  +  +--+  +  +  +--+  +--+  +  +--+--+--+  +  +--+--+  +  +  +--+--+  +  +--+--+--+  +  +  +  +  +  +--+  +
|  |     |     |        |        |  |     |  |     |  |  |     |     |                 |     |  |     |     |     |           |     |  |  |  |     |
+  +--+  +  +--+--+--+  +--+  +--+  +  +--+  +  +--+  +  +  +--+  +--+--+  +--+--+  +--+  +  +  +--+--+  +  +--+--+  +--+--+--+--+--+  +  +  +--+--+
|     |  |  |        |     |     |     |  |     |  |  |     |              |     |  |     |  |  |        |     |  |        |     |     |  |     |  |
+  +--+  +  +  +--+  +--+--+--+  +--+--+  +--+--+  +  +--+--+  +--+--+--+--+--+  +--+  +--+  +  +  +--+--+--+  +  +--+--+  +  +  +--+--+  +--+  +  +
|     |  |        |  |           |        |        |  |     |     |     |  |        |  |     |  |  |           |        |     |  |     |  |     |  |
+  +  +  +--+--+  +  +  +--+--+--+  +--+--+  +--+  +  +  +  +--+  +  +  +  +  +  +  +  +  +--+--+  +  +--+--+--+--+--+  +--+--+  +  +  +  +--+  +  +
|  |     |        |  |  |                       |     |  |     |     |     |  |  |     |     |     |     |        |  |  |     |     |           |  |
+  +--+--+  +--+--+--+  +  +--+--+--+--+--+--+  +--+--+  +  +  +--+--+--+  +  +  +--+--+--+--+  +--+--+  +  +--+  +  +  +--+  +--+--+--+  +--+--+  +
|     |  |     |        |  |     |              |  |     |  |  |     |     |  |        |     |     |     |     |  |     |     |           |        |
+--+  +  +--+  +  +--+--+  +  +--+  +--+--+--+--+  +  +--+  +  +--+  +  +--+  +--+--+  +  +  +--+  +--+  +  +--+  +  +  +  +--+  +--+--+--+--+  +  +
|     |        |     |     |     |           |           |  |        |     |        |     |     |  |     |     |     |     |  |        |        |  |
+  +--+--+--+--+--+  +  +--+--+  +--+  +--+  +  +--+--+--+  +--+--+--+--+  +--+  +--+--+--+--+  +  +  +--+--+  +--+--+--+--+  +--+--+  +  +--+--+  +
|     |                 |              |     |        |     |           |     |  |        |  |  |  |        |     |  |     |           |        |  |
+--+  +--+--+--+--+  +--+--+--+--+--+--+  +--+--+--+  +  +--+  +--+--+  +--+  +--+  +--+  +  +  +  +--+--+  +--+  +  +  +  +  +--+  +--+--+--+  +--+
|  |     |           |     |     |     |           |  |        |     |  |        |     |  |        |     |  |     |     |     |  |  |              |
+  +--+  +  +--+--+--+--+  +  +--+  +  +--+  +  +--+  +--+--+--+  +  +  +  +  +  +--+  +  +  +  +--+  +--+  +  +--+--+--+--+--+  +  +  +--+--+  +  +
|        |        |     |  |        |        |        |           |  |     |  |        |  |  |  |     |     |        |              |        |  |  |
+--+--+--+--+--+  +  +  +  +  +--+--+--+--+--+--+--+--+  +--+  +--+  +--+--+  +--+--+--+  +  +  +  +--+  +--+  +--+  +  +--+--+--+--+--+--+  +--+  +
|                    |     |  |           |           |     |     |        |        |     |  |     |     |  |  |     |     |        |        |     |
+  +--+--+--+--+--+--+--+--+--+  +--+  +--+  +--+--+  +--+  +--+  +--+--+--+--+--+  +  +--+  +--+--+  +--+  +  +--+--+  +  +--+  +  +--+--+--+  +--+
|                 |  |           |     |     |     |     |     |        |     |     |        |     |  |     |     |     |     |  |     |     |  |  |
+--+--+--+--+--+  +  +  +--+--+--+--+  +  +--+  +--+  +--+--+  +--+--+  +  +  +  +--+--+--+--+  +  +  +  +--+--+  +--+  +--+  +  +--+  +  +--+  +  +
|     |           |        |     |        |  |        |        |           |     |     |     |  |     |  |     |  |     |     |     |     |     |  |
+  +  +  +--+--+--+--+--+  +  +  +  +--+--+  +--+--+  +  +--+--+  +--+  +--+--+--+--+  +  +--+  +--+--+  +  +  +  +  +--+  +--+--+  +  +--+  +--+  +
|  |     |     |           |  |  |           |     |  |  |     |  |  |  |     |        |     |           |  |  |     |     |        |     |  |  |  |
+  +--+--+  +  +  +--+--+--+  +  +--+--+  +  +  +  +--+  +--+  +  +  +  +  +  +  +--+--+--+  +--+--+  +--+--+  +--+--+  +--+  +  +  +--+  +  +  +  +
|           |  |  |        |  |     |     |  |  |        |     |  |     |  |  |     |     |                 |  |        |     |  |     |     |     |
+--+--+--+--+  +  +  +--+  +  +--+  +--+--+--+  +--+--+--+  +--+  +  +--+  +  +--+  +  +--+--+--+--+  +--+  +  +  +  +--+  +--+  +--+--+--+--+--+  +
|              |  |  |     |  |  |        |                 |     |  |     |        |              |  |     |  |  |     |  |  |  |        |        |
+  +  +--+--+--+  +  +  +--+  +  +--+--+  +  +--+--+--+--+--+  +--+--+  +  +--+--+--+--+--+--+  +--+  +  +--+  +  +--+--+  +  +  +  +--+  +  +--+  +
|  |  |              |  |     |           |  |     |           |        |           |        |        |        |  |        |  |  |  |  |     |     |
+--+  +--+--+  +  +--+  +  +--+--+--+--+--+--+  +--+  +--+--+--+  +--+--+--+--+--+  +  +--+--+--+--+--+--+  +--+  +  +--+--+  +  +  +  +  +--+  +--+
|     |     |  |  |     |  |     |           |  |     |     |     |                 |                    |     |  |  |     |  |  |  |  |     |  |  |
+  +--+  +  +--+  +  +--+  +  +  +  +--+--+  +  +  +--+--+  +  +--+--+--+--+--+--+--+--+--+--+--+--+--+  +--+  +  +  +  +  +  +  +  +  +--+  +  +  +
|  |     |        |  |     |  |     |        |        |     |              |                 |        |  |     |     |  |  |        |  |     |     |
+  +  +  +--+--+--+  +  +--+  +--+--+  +  +--+--+--+--+  +--+  +--+--+--+  +--+  +--+--+--+--+  +--+--+  +  +--+--+--+--+  +--+  +--+  +  +--+--+  +
|     |  |           |  |        |     |  |           |  |        |        |     |           |              |  |        |        |     |  |        |
+  +--+--+  +--+--+--+  +  +--+  +  +--+  +--+--+--+  +  +  +--+--+  +--+--+  +--+  +--+--+  +--+--+--+  +--+  +  +--+  +--+  +--+  +  +  +--+--+  +
|  |        |     |     |  |     |  |     |     |     |  |  |        |           |  |        |        |     |     |  |     |        |  |     |     |
+--+  +--+--+  +  +  +--+--+  +--+  +  +--+  +  +  +--+  +  +  +--+--+--+  +--+  +--+  +--+--+  +--+  +  +--+--+--+  +--+  +  +--+--+  +--+  +  +--+
|     |        |     |        |     |  |     |     |        |           |     |        |        |  |     |     |        |     |     |  |     |     |
+  +--+  +  +--+--+  +  +--+--+  +--+  +  +--+--+--+  +  +--+--+--+--+  +--+--+  +--+  +  +--+--+  +--+--+  +  +  +  +--+--+--+--+  +--+  +--+--+--+
|        |     |  |     |        |  |  |        |     |  |        |  |  |     |  |     |  |     |     |     |  |  |           |           |        |
+--+  +--+--+  +  +--+--+  +--+--+  +  +--+--+  +  +--+  +  +--+  +  +  +  +  +  +  +--+  +  +  +--+  +  +--+  +  +--+--+--+  +  +  +--+--+--+--+  +
|     |        |  |     |     |     |        |  |  |     |     |     |  |  |     |     |  |  |  |     |     |  |     |  |     |  |  |           |  |
+--+--+  +--+--+  +--+  +--+  +  +  +  +--+  +  +  +--+--+--+  +--+--+  +  +--+--+--+--+  +  +  +  +--+--+  +  +--+  +  +  +--+  +  +--+--+  +  +  +
|     |  |           |        |  |  |  |     |  |  |        |  |     |     |           |     |  |  |     |  |  |  |     |        |        |  |  |  |
+  +  +  +--+--+--+  +--+--+--+  +  +  +  +--+  +  +  +  +  +  +--+  +--+--+  +--+--+  +--+--+  +  +--+  +  +  +  +--+--+--+--+--+--+--+  +  +  +  +
|  |  |              |     |     |     |           |  |  |  |     |     |     |  |              |     |     |  |  |     |     |        |  |  |  |  |
+  +--+  +--+--+--+--+  +  +  +--+--+--+  +--+--+  +  +  +--+--+  +--+  +  +--+  +  +  +--+--+--+  +  +--+  +  +  +  +  +  +--+  +--+  +  +  +  +  +
|  |     |              |  |  |     |     |        |  |     |  |  |  |     |  |     |     |     |  |     |  |  |     |  |     |     |     |  |  |  |
+  +  +--+  +--+--+--+--+  +  +  +  +--+--+  +--+--+--+--+  +  +  +  +--+--+  +--+--+  +  +  +  +  +--+  +  +  +  +  +--+--+  +--+  +--+--+--+  +  +
|     |     |                 |  |  |        |              |     |           |  |     |     |     |     |  |  |  |  |     |     |        |     |  |
+--+--+--+  +  +--+--+--+  +--+  +  +  +--+--+  +--+--+--+--+  +--+--+  +--+--+  +  +--+--+--+--+--+--+--+--+  +  +  +  +--+--+  +--+--+  +  +--+  +
|     |     |  |     |  |        |  |     |              |     |     |     |  |  |           |           |        |  |     |  |        |     |     |
+  +--+  +--+  +--+  +  +--+--+--+  +--+  +  +--+--+--+  +  +--+  +  +--+  +  +  +--+--+--+  +  +--+--+  +  +  +--+--+--+  +  +--+  +  +--+  +  +--+
|        |  |     |  |     |     |     |  |        |     |  |     |     |     |        |     |  |        |  |  |        |  |     |  |     |        |
+--+--+--+  +--+  +  +--+  +  +--+--+  +  +--+--+  +  +--+  +  +--+  +--+--+  +--+  +  +  +--+  +  +--+--+  +  +  +  +  +  +--+  +--+--+  +--+  +  +
|     |     |     |     |  |  |        |           |        |  |     |     |     |  |  |        |     |  |  |  |  |  |  |  |        |  |        |  |
+  +  +  +--+  +--+  +  +  +  +  +--+--+  +--+--+--+--+--+  +  +--+  +  +--+  +  +--+  +--+  +--+--+  +  +  +  +  +--+  +  +  +  +  +  +--+--+--+  +
|  |           |     |     |  |  |     |        |           |     |  |        |           |  |        |     |  |     |  |     |  |        |     |  |
+  +--+  +--+--+  +--+--+--+  +  +--+  +--+--+  +--+--+--+--+--+  +--+--+--+--+--+--+  +  +  +--+--+--+--+--+  +--+  +  +--+--+  +--+--+--+  +  +  +
|  |     |     |        |     |     |  |     |  |     |  |     |  |                    |     |        |     |  |     |  |     |        |     |     |
+  +--+--+--+  +--+--+  +  +--+  +  +  +--+  +  +  +  +  +  +  +  +  +--+--+--+--+--+--+--+--+  +--+  +  +  +  +--+--+  +--+  +--+--+  +  +--+--+--+
|  |        |     |        |     |  |     |        |  |     |     |        |        |        |  |     |  |  |        |     |     |  |           |  |
+  +  +--+  +  +  +  +  +--+--+--+  +--+  +--+--+--+  +  +--+--+--+--+--+  +  +  +--+  +--+  +  +  +--+--+  +--+  +  +--+  +--+  +  +--+  +--+  +  +
|  |     |  |  |     |              |     |  |        |     |     |     |     |        |  |  |  |     |           |           |  |        |  |  |  |
+  +--+--+  +--+--+--+--+  +--+--+--+  +--+  +  +  +--+--+  +  +  +  +  +--+--+--+--+--+  +  +  +--+  +  +--+  +--+--+--+--+  +  +  +--+--+  +  +  +
|           |              |     |  |           |        |     |  |  |           |     |     |  |     |  |     |        |     |  |     |     |  |  |
+--+--+--+--+  +--+--+--+--+  +  +  +--+--+  +--+--+--+--+--+--+  +  +--+--+--+  +  +  +--+  +  +  +--+  +  +--+--+--+  +  +--+  +--+  +  +  +  +  +
|  |        |           |     |     |     |     |  |     |     |     |  |           |  |        |  |     |     |        |  |     |        |  |     |
+  +  +--+  +--+--+--+  +  +  +  +--+  +  +--+  +  +  +  +  +--+--+--+  +  +--+--+--+  +--+--+  +  +  +--+--+  +  +--+--+  +  +--+  +  +--+  +--+--+
|  |  |  |           |  |  |  |        |     |     |  |     |           |     |     |  |        |     |     |        |     |  |  |  |     |  |     |
+  +  +  +--+--+--+  +  +--+  +--+--+--+  +  +--+--+  +  +--+  +--+--+--+--+  +  +  +  +  +--+--+--+--+  +--+--+--+  +  +--+  +  +  +--+  +  +  +  +
|        |                    |           |           |                       |  |     |              |              |        |     |     |     |  F
+--+--+--+--+--+--+--+--+--+--+--+--+--+--+--+--+--+--+--+--+--+--+--+--+--+--+--+--+--+--+--+--+--+--+--+--+--+--+--+--+--+--+--+--+--+--+--+--+--+
