+--+--+--+--+--+--+--+--+--+--+--+--+--+--+--+--+--+--+--+--+--+--+--+--+--+--+--+--+--+--+--+--+--+
S  |        |                 |     |           |                    |  |        |     |  |        |
+  +  +--+  +  +--+  +--+--+  +--+  +  +  +--+  +  +--+--+  +--+--+  +  +  +--+  +  +  +  +  +--+  +
|  |  |     |  |           |     |  |  |     |     |     |  |        |  |  |  |     |        |     |
+  +  +  +--+  +--+  +--+  +--+  +  +  +--+--+--+--+  +  +  +--+--+--+  +  +  +--+--+--+--+--+  +--+
|     |     |     |  |     |  |  |  |  |     |        |  |        |        |  |                    |
+--+--+--+  +--+  +--+  +  +  +  +  +--+  +  +  +--+--+  +--+--+  +--+--+--+  +  +--+--+  +--+  +  +
|           |        |  |     |  |  |     |  |     |     |                    |  |        |     |  |
+  +  +--+--+--+--+  +  +--+--+  +  +  +--+  +--+  +--+--+  +--+--+--+--+  +--+  +--+--+--+  +--+  +
|  |  |              |  |     |     |  |     |        |     |           |  |  |        |  |     |  |
+  +  +  +--+--+--+--+  +  +  +--+--+  +  +--+--+--+  +--+--+  +--+  +  +  +  +--+--+  +  +--+  +  +
|  |  |              |  |  |     |     |  |                 |     |  |  |              |     |  |  |
+  +--+--+--+--+--+  +  +  +--+  +  +--+  +  +--+--+  +--+  +--+--+  +  +--+--+--+--+--+  +  +  +--+
|        |     |     |  |  |  |     |  |     |     |  |        |     |           |     |  |  |     |
+--+--+  +  +--+  +--+  +  +  +--+--+  +--+--+--+  +  +--+--+--+  +--+--+--+  +  +  +  +--+  +--+  +
|  |     |        |  |  |  |     |     |     |     |     |     |  |           |  |  |     |  |     |
+  +  +  +  +--+--+  +  +  +--+  +  +--+  +  +  +  +--+  +  +  +  +  +--+  +--+--+  +--+  +  +  +  +
|  |  |     |           |     |  |        |     |           |  |  |     |        |  |     |     |  |
+  +  +--+--+  +--+--+--+--+  +  +--+--+--+--+--+--+--+  +--+  +--+--+  +--+--+  +  +  +--+  +--+  +
|     |  |           |        |                          |  |     |     |     |  |  |  |     |     |
+--+--+  +  +--+--+  +  +--+--+--+--+--+--+--+--+--+--+--+  +--+  +--+--+  +  +  +  +  +  +--+  +--+
|        |        |     |        |     |     |        |     |     |        |     |  |     |     |  |
+  +--+--+--+  +  +--+--+--+--+  +  +  +  +--+  +--+  +  +--+  +--+  +--+--+  +--+  +--+--+  +--+  +
|  |        |  |     |        |  |  |  |     |  |     |     |              |  |     |     |        |
+  +  +--+  +  +--+  +  +--+  +  +  +  +  +  +  +  +--+--+  +  +  +--+--+  +  +  +--+  +  +--+--+--+
|  |     |     |  |     |  |  |     |     |     |        |     |  |     |  |     |     |  |        |
+  +--+  +  +--+  +--+--+  +  +  +--+--+--+  +--+--+--+  +--+--+  +--+  +  +--+--+  +--+  +  +--+  +
|        |     |           |     |     |     |           |     |        |  |  |     |     |  |  |  |
+--+--+--+--+  +  +--+--+--+--+--+  +  +  +--+  +--+--+--+--+  +--+--+--+  +  +  +--+  +--+  +  +  +
|     |     |  |  |     |        |  |     |     |     |     |  |        |     |  |     |     |     |
+--+  +  +  +  +  +  +  +  +--+  +  +--+--+--+--+--+  +  +  +  +  +--+--+  +  +  +  +--+  +--+--+--+
|     |  |  |  |  |  |     |     |                 |  |  |     |        |  |     |        |     |  |
+  +--+  +  +  +  +  +--+--+  +--+--+--+--+--+  +  +  +  +--+--+--+--+  +  +--+--+--+--+--+  +  +  +
|        |  |  |  |  |     |  |                 |     |  |        |     |        |     |     |     |
+  +--+--+--+  +  +  +  +--+  +  +--+--+--+  +--+--+--+  +  +--+  +  +--+--+--+  +  +  +--+--+  +--+
|  |           |     |        |        |     |  |     |     |     |  |  |           |     |  |     |
+  +  +  +--+--+  +  +--+--+--+--+--+  +  +--+  +  +  +--+  +  +--+  +  +  +--+--+--+--+  +  +--+  +
|     |        |  |           |        |  |  |     |        |     |  |     |              |        |
+--+--+--+--+  +--+--+  +--+--+  +--+--+  +  +  +--+  +--+--+--+  +  +--+--+  +--+--+  +--+--+--+  +
|              |     |           |  |     |  |     |     |     |  |        |     |     |     |     |
+  +--+--+--+--+  +  +--+--+--+--+  +  +  +  +--+--+--+  +--+  +  +--+--+  +--+  +--+--+  +  +--+  +
|           |  |  |        |     |     |     |  |     |     |  |  |        |     |     |  |        |
+--+--+--+  +  +  +--+--+  +  +  +--+--+--+--+  +  +  +--+  +  +  +  +--+--+  +--+  +  +  +--+--+--+
|           |  |     |        |  |     |        |  |        |     |  |     |  |     |              |
+  +--+  +--+  +--+  +  +--+--+  +--+  +  +--+--+  +--+--+--+--+--+  +  +  +  +  +--+--+--+--+--+  +
|     |  |        |  |  |     |     |  |  |     |              |     |  |     |  |     |           |
+--+  +  +--+  +--+  +  +  +  +--+  +  +  +  +  +--+  +  +  +  +--+  +  +--+--+  +  +  +  +--+  +--+
|  |  |  |     |     |     |     |  |  |  |  |        |  |  |     |  |  |        |  |  |  |     |  |
+  +  +  +  +--+  +  +--+--+--+  +  +  +  +  +  +--+--+--+  +--+  +  +  +  +--+--+  +  +  +  +--+  +
|     |  |        |     |        |     |     |  |     |     |  |  |  |     |        |  |  |        |
+--+--+  +--+--+--+--+  +  +  +--+--+--+--+--+  +  +  +  +--+  +  +  +  +--+  +--+--+--+  +--+  +--+
|        |     |  |     |  |  |  |           |  |  |  |  |     |     |  |        |        |        |
+  +--+--+--+  +  +  +--+--+  +  +  +--+--+  +  +  +--+  +  +--+--+--+  +  +--+--+  +--+--+--+--+--+
|     |           |  |        |  |  |     |  |  |        |        |     |           |     |        |
+--+  +  +--+  +--+  +  +--+--+  +  +  +--+  +  +--+--+--+--+  +  +  +--+--+  +--+--+  +  +  +--+  +
|     |     |     |  |  |     |  |  |     |     |              |  |  |     |     |     |     |     |
+  +--+--+  +--+--+  +  +  +  +  +  +  +  +--+--+  +--+--+--+--+  +  +--+  +--+  +  +--+--+--+  +--+
|  |     |  |     |  |     |        |  |  |     |  |     |        |        |     |  |        |     |
+  +--+  +  +  +  +  +--+  +--+  +--+--+  +  +  +  +--+  +  +--+  +--+--+--+  +--+  +  +--+--+--+  +
|  |     |  |  |     |     |     |     |  |  |  |     |     |     |        |        |              |
+  +  +--+  +  +--+--+--+--+  +--+  +  +  +  +  +--+  +--+--+--+--+  +--+  +--+--+--+  +--+--+--+--+
|  |     |  |  |           |  |     |  |  |  |  |     |              |  |  |     |     |     |     |
+  +  +  +  +  +  +--+--+  +  +  +--+  +  +  +  +  +--+  +--+--+--+--+  +  +  +--+  +--+--+  +  +  +
|  |  |     |  |  |        |  |  |  |        |     |     |           |     |  |     |        |  |  |
+  +  +--+  +  +  +  +--+--+  +  +  +--+  +--+--+--+--+--+  +--+--+--+  +--+  +  +--+  +--+--+  +  +
|        |     |  |  |     |     |        |           |     |        |  |     |        |        |  |
+--+--+  +--+--+  +  +  +  +--+  +--+--+  +--+--+--+  +  +  +  +--+  +  +--+  +--+--+--+  +--+--+  +
|        |        |     |     |  |     |  |        |  |  |     |     |  |              |  |     |  |
+  +--+--+  +--+--+  +--+--+--+  +  +  +  +  +--+  +  +  +--+--+  +--+  +  +--+--+--+  +  +--+  +  +
|  |        |           |     |     |  |  |     |        |     |  |        |     |     |     |  |  |
+  +--+  +--+  +--+--+--+  +  +--+--+  +  +  +  +--+--+--+  +  +  +--+  +--+  +  +--+--+--+  +  +  +
|  |     |     |     |     |  |        |  |  |        |     |  |           |  |     |     |  |  |  |
+  +  +--+  +--+--+  +  +--+  +  +--+--+  +  +--+--+  +  +--+  +--+--+  +  +  +--+  +  +--+  +  +  +
|  |  |     |     |  |  |  |  |  |     |  |  |        |     |     |     |  |  |  |  |  |     |     |
+  +  +  +  +  +  +  +  +  +  +  +  +  +--+  +  +--+--+--+  +  +--+  +--+  +  +  +  +  +  +--+--+--+
|  |  |  |     |     |  |     |     |  |     |     |     |  |        |     |     |  |  |  |     |  |
+  +  +  +--+--+--+  +  +  +--+--+--+  +  +--+--+  +--+  +  +--+--+--+  +--+--+--+  +  +  +  +  +  +
|  |  |     |        |  |     |     |  |     |  |        |  |        |     |     |        |  |  |  |
+  +  +--+  +  +  +--+  +  +  +  +--+  +  +  +  +--+  +--+  +  +--+  +--+  +  +  +--+  +--+  +  +  +
|     |     |  |     |  |  |  |     |     |  |     |  |     |     |  |     |  |     |        |  |  |
+--+--+  +--+--+--+--+  +  +  +--+  +  +--+  +--+  +--+  +--+--+  +  +  +--+--+  +  +--+  +--+  +  +
|        |     |        |  |  |     |     |     |  |     |        |  |  |     |  |     |     |  |  |
+  +--+--+  +  +  +--+--+  +  +  +--+--+--+--+  +  +  +--+  +--+--+  +  +  +  +  +--+--+--+  +  +  +
|  |     |  |  |  |     |  |  |  |                 |     |  |     |  |  |  |           |     |  |  |
+  +  +  +  +--+  +--+  +--+  +  +  +--+--+--+  +--+--+  +  +  +--+  +  +--+--+  +--+  +  +  +  +  +
|     |  |  |     |     |     |     |        |        |     |        |           |     |  |  |     |
+  +--+  +  +  +--+  +--+  +--+--+--+  +--+--+--+--+  +--+--+--+--+--+  +--+--+--+  +--+--+  +--+--+
|     |     |  |     |     |     |     |     |     |           |     |  |        |        |        |
+  +  +--+--+  +  +--+  +--+--+  +  +  +  +  +  +  +--+--+--+  +--+  +  +  +--+  +--+--+  +--+--+  +
|  |  |        |  |     |     |  |  |     |  |  |        |        |        |     |        |        |
+  +--+  +--+--+  +--+--+  +  +  +  +--+--+  +  +--+  +  +--+--+  +--+  +--+--+  +  +--+--+  +--+--+
|     |  |     |     |     |  |  |        |     |     |           |     |  |     |                 |
+--+  +  +  +  +--+  +  +  +  +  +  +--+  +--+--+--+--+--+--+--+--+  +--+  +  +--+--+--+--+--+--+  +
|     |  |  |     |  |  |  |  |  |     |  |        |     |  |        |     |     |           |     |
+  +--+  +--+  +  +  +--+  +  +  +--+--+  +  +--+  +  +  +  +  +--+  +  +--+  +--+  +--+--+--+  +--+
|  |     |     |     |     |     |        |  |  |  |  |     |  |     |  |        |              |  |
+  +  +  +  +  +--+--+  +  +--+--+  +--+--+  +  +  +  +--+--+  +  +--+  +--+--+  +--+--+  +--+--+  +
|     |     |           |        |           |     |           |     |                 |           F
+--+--+--+--+--+--+--+--+--+--+--+--+--+--+--+--+--+--+--+--+--+--+--+--+--+--+--+--+--+--+--+--+--+
