+-+-+-+-+-+
|S|     | |
+ + +-+ + +
| | |F  | |
+ + +-+ + +
|     |   |
+-+-+-+-+-+
