+--+--+--+--+--+--+--+--+--+--+--+--+--+--+--+--+--+--+--+--+--+--+--+--+--+--+--+--+--+--+
S                                                                                         |
+                                                                                         +
|                                                                                         |
+                                                                                         +
|                                                                                         |
+                                                                                         +
|                                                                                         |
+                                                                                         +
|                                                                                         |
+                                                                                         +
|                                                                                         |
+                                                                                         +
|                                                                                         |
+                                                                                         +
|                                                                                         |
+                                                                                         +
|                                                                                         |
+                                                                                         +
|                                                                                         |
+                                                                                         +
|                                                                                         |
+                                                                                         +
|                                                                                         |
+                                                                                         +
|                                                                                         |
+                                                                                         +
|                                                                                         |
+                                                                                         +
|                                                                                         |
+                                                                                         +
|                                                                                         |
+                                                                                         +
|                                                                                         |
+                                                                                         +
|                                                                                         |
+                                                                                         +
|                                                                                         |
+                                                                                         +
|                                                                                         |
+                                                                                         +
|                                                                                         |
+                                                                                         +
|                                                                                         |
+                                                                                         +
|                                                                                         |
+                                                                                         +
|                                                                                         |
+                                                                                         +
|                                                                                         |
+                                                                                         +
|                                                                                         |
+                                                                                         +
|                                                                                         |
+                                                                                         +
|                                                                                         |
+                                                                                         +
|                                                                                         |
+                                                                                         +
|                                                                                         F
+--+--+--+--+--+--+--+--+--+--+--+--+--+--+--+--+--+--+--+--+--+--+--+--+--+--+--+--+--+--+
