+-+-+-+-+-+
|S|     | |
+ + +-+ + +
| | |F  | |
+ + +-+ + +
| | |     |
+ + +-+-+ +
|     |   |
+ + +-+-+ +
| |       |
+-+-+-+-+-+
